4000016373
4000017620
4000013411
4000014143
4000018160
4000014663*